0000000000000000000000000000000000000000000000000000000000000000
0000000000000000000000000000000000000000000000000000000000000000
0000000000000000000000000000000000000000000000000000000000000000
0000000000000000000000000000000000000000000000000000000000000000
0000000000000000000000000000000000000000000000000000000000000000
0000000000000000000000000000000000000000000000000000000000000000
0000000000000000000000000000000000000000000000000000000000000000
0000000000000000000000000000000000000000000000000000000000000000
0000000000000000000000000000000000000000000000000000000000000000
0000000000000000000000000000000000000000000000000000000000000000
0000000000000000000000000000000000000000000000000000000000000000
0000000000000000000000000000000000000000000000000000000000000000
0000000000001111111111111111111111111111111111111000000000000000
0000000000001000000000000000000000000000000000001000000000000000
0000000000001000200000000000000050000000000000001000000000000000
0000000000001000000000000000000000000000000000001000000000000000
00000000000010000*0000111111000000011111100000001000000000000000
0000000000001000000000100001000000010000100000001000000000000000
0000000000001000000000100001000000010000100000001000000000000000
0000000000001000000000100001000000010000100000001000000000000000
0000000000001000000000100001000000010000100000001000000000000000
0000000000001000000000100001000000010000100000001000000000000000
0011111111111000000000000000000000000000000000001111111111111000
0010000000000000000002000000000000000000000000000000000000001000
00100000000000000000000000000000000000400000000000000*0000001000
0010000000000000000000000000000000000000000000000000000000001000
0011111111111000000011111110000000100000011111110000000000001000
0000001000000000000010000010000000100000010000010000030000001000
0000001000005000000010000010000000100000010000010000000000001000
0000001000000000*00010000010000000100*00010000010000000000001000
0000001000000000000010000010000000100000010000010000000000001000
0000001111111111111110000011111111111111110000011111111111111000
0000000000000000000000000000000000000000000000000000000000000000
0000000000000000000000000000000000000000000000000000000000000000
0000000000000000000000000000000000000000000000000000000000000000
0000000000000000000000000000000000000000000000000000000000000000
0000000000000000000000000000000000000000000000000000000000000000
0000000000000000000000000000000000000000000000000000000000000000
0000000000000000000000000000000000000000000000000000000000000000
0000000000000000000000000000000000000000000000000000000000000000
0000000000000000000000000000000000000000000000000000000000000000
0000000000000000000000000000000000000000000000000000000000000000
0000000000000000000000000000000000000000000000000000000000000000
