0000000000000000000000000000000000000000000000000000000000000000
0000000000000000000000000000000000000000000000000000000000000000
0000000000000000000000000000000000000000000000000000000000000000
0000000001111111111110000000000000000000000000000000000000000000
0000000001000000000010000000000000000000000000000000000000000000
0000000001000000000011111100000000000000000000000000000000000000
0000000001000000400000000100000000000000000000000000000000000000
0000000001000000000000000100000000000000000000000000000000000000
0000000001000000000000000100000000000000000000000000000000000000
00000000010000000*0000000100000000000000000000000000000000000000
0000000001111000000000000111111000000000000000000000000000000000
0000000000001000000000000000001000000000000000000000000000000000
0000000000001000000000000000001000000000000000000000000000000000
0000000000001000000000000000001000000000000000000000000000000000
0000000000001000000000000000001000000000000000000000000000000000
0000000000001111111000000000001111110000000000000000000000000000
0000000000000000001000000000000000010000000000000000000000000000
0000000000000000001000000000000000010000000000000000000000000000
0000000000000000001000000000000000010000000000000000000000000000
0000000000000000001000000000200000010000000000000000000000000000
0000000000000000001111110000000000011111100000000000000000000000
0000000000000000000000010000000000000000100000000000000000000000
0000000000000000000000010000000000000000100000000000000000000000
0000000000000000000000010000000000000000100000000000000000000000
0000000000000000000000010000000000000000100000000000000000000000
0000000000000000000000011111100000000000111111110000000000000000
0000000000000000000000000000100000000000000000010000000000000000
0000000000000000000000000000100000000000000000010000000000000000
0000000000000000000000000000100000000030000000010000000000000000
0000000000000000000000000000100000000000000000011111100000000000
0000000000000000000000000000111111000000000000000000100000000000
0000000000000000000000000000000001000000000000000000100000000000
0000000000000000000000000000000001000000000000000000100000000000
0000000000000000000000000000000001000000000000000000100000000000
0000000000000000000000000000000001000000000000000000100000000000
0000000000000000000000000000000001111111111111111111100000000000
0000000000000000000000000000000000000000000000000000000000000000
0000000000000000000000000000000000000000000000000000000000000000
0000000000000000000000000000000000000000000000000000000000000000
0000000000000000000000000000000000000000000000000000000000000000
0000000000000000000000000000000000000000000000000000000000000000
0000000000000000000000000000000000000000000000000000000000000000
0000000000000000000000000000000000000000000000000000000000000000