1111111111111111111111111111111111111111111111111111111111111111
1000000000000000000000000000000000000000000001000000000000000001
1000000000000000000000000000000000000000000001000000000000000001
1000000000000000000000000000000000000000000001000000000000000001
10000000000*0000001111111111110000000000000000000000000000000001
1111000000000000000000000000010000000000000000000030000000000001
1000000000000000000000000000010000000000000000000000000000000001
1000000000000000000000000000010000000000000000000000000000000001
1000000000000000000000000000010000000000000000000000000000000001
1000001110000000000011111111110000000000000000011111111111111111
100000011000000000000000000000000000000000000001000000*000000001
1000000010000000000000000000000000000001111111110000000000000001
1000000000000000000000000000000000000000000000000000000000000001
1000000011111000000000000000000000000000000000000000000000000001
1000000000000000000000000000000000000000000000000000000000000001
1000000000000000000000000000000000000000000000010000000000000001
1000000000000000000000000111111111111111111111110000000000000001
10000000111110000000000000000100000100*0000000000000000000000001
1000000000000000000004000000000000010000000000000000000000000001
1000000000000000000000000000000000010000000000000000000000000001
1000000000000000000000000000000000010000000000000000000000000001
1000000000010000000000000000000000010000000000000000000000000001
1000000000010000000000000000010000010000000000000000000000000001
1000000000011111100000000011111111110000000001111111110000000001
1000000000000000100000000000000000000000000001000000000000000001
10000000000000*0100000000000000000000000000001000000000000000001
1000000000000000100000000000000000000000000001000000000000000001
1110000000111111100000000000000000000000000001000000000000000001
1000000000000000000000000000111110000001111111111111000000000001
1000000000000000000000000000100000000000010000000000000000000001
1000000000000000000000000000000000000000010000000000000000000001
1000000000000000000000000000000000000000010000000000000000000001
1000000000000000000000000000000000000000010000000000000000000001
1000000011111111000000000000100000000000000000000006000000000001
1000000010000001000000000000100000000000000000000000000000000001
1000000010000001111111111111100000000000000000000000000000000001
1000000010000001000000000000000000000000000000000000000000000001
1000000010000001000000000000000000000000000000000000000000000001
1000000010000001000000000000000000000000000000000000000000000001
1000000010000001000000000000000000011111111111111111100000000001
1000000000000001000000000000000000010000000000000000000000000001
1000000000000001000000000000000000010000000000000000000000000001
1111111111111111111111111111111111111111111111111111111111111111