1111111111111111111111111111111111111111111111111111111111111111
1000000000000000000000000000000000000000000001000000000000000001
1000000000000000000000000000000000000000000001000000000000000001
1000000000000000000000000000000000000000000001000000000500000001
1000000000000000000111111111110000000000000000000000000000000001
1111000000111111111100000000010000000000000000000000000000000001
1000000000000001000000000000010000000000000000000000000000000001
1000000000000000000000000000010000000000000000000000000000000001
1000000000000000000000000000010000000000000000000000000000000001
100000000*000000000011111111110000000000000000011111111111111111
1000000000000000000000000000000000000000000000010000000000000001
1000000000000000000000000000000000000001111111110000000000000001
1000000000000000000000000000000000000000000000000000000000000001
1000000011111000000000000000010000000000000000000000000000000001
1000000000000000000000000000010000000000000000000000000000000001
1000000000000000000000000000010000000000000000010000000000000001
1000000000000000000000000111111111111111111111110000000000000001
10000000111110000000000000000100000100000000000000000000*0000001
1000000000000000000000000000000000000000000000000000000000000001
1000000000000000000000000000000000000000000000000000000000000001
1000000111110000000000000000000000000000000600000000000000000001
1000000000010000000000000000000000000000000000000000000000000001
1000000000010000000000000000000000010000000000000000000000000001
1000000000011111100000000011111111110000000001111111110000000001
1000000000000000100000000000000000000000000001000000000000000001
1000000000000000100000000000000000000000000001000000000000000001
1000000000000000100000000000000000000000000001000000000000000001
1110000000111111100000000000000000000000000001000000000000000001
1000000000000000000000000000111110000001111111111111000000000001
1000000000000000000000000000100000000000010000000000000000000001
1000000000000-00000000000000000000000000010000000000000000000001
1000000000000000000000000000000000000000010000000000000000000001
1000000000000000000000000000000000000000010000000000000000000001
1000000000000000000000000000000000000000000000000000000000000001
1000000010000001000000000000100000000000000000000000000000000001
1000000010000001111111111111100000000000000000000000000000000001
1000000010000001000000000000000000000000000000000000000000000001
1000000010000001000000000000000000000000000000000000000000000001
1000000010000001000000000000000000010000000000000000030000000001
1000000010000001000000000000000000010000000000000000000000000001
1000000000000001000000000000000000010000000000000000000000000001
1000000000000001000000000000000000010000000000000000000000000001
1111111111111111111111111111111111111111111111111111111111111111