1111111111111111111111111111111111111111111111111111111111111111
1000000000000000000000000000010000000000000001000000000000000001
1000000000000000000000000000010000000000000001000000000000000001
1000000000000000000000000000010000000000000001000000000000000001
1111111111111100000000000000010000000000000001000000011111111111
10000001000000000000000000*0010000000000000001000000010000000001
100000010000000000*000000000010000000000000001000000010000400001
1000000100000000000000000000010000011111000001000000010000000001
1000000100000000000000000000000000000000000000000000010000000001
1000000100000000000000000000000000000000000000000000010000000001
1000000111111100000000000000000000000000000000000000010000000001
1000000000000100000000000000000000000000000000000000010000000001
1000000000000100000000000001000000000000000000000000010000000001
1000000000000100000000000001000000000000000000000000010000000001
1000000000000100000000000001000000000000000010000000010000000001
1000000111111100000000000001000000000000000010000000010000000001
1000000000000000000000000001000000000000000010000000000000000001
1000000000000000000000000001000000000000000010000000000000000001
1000003000000000000000000001000000000000000010000000000000000001
1000000000000000000000000001000000000000000010000000000000000001
1000000000000000000000000001000000000000000010000000000000000001
1000000000000100000000000001000000000000000010000000000000000001
1000000000000100000000000001000000000000000010000000000000000001
1000000000000100000000111111000000000000000010000000000000000001
1000000000000100000000000000000000000000000010000000010000000001
1000000000000100000000000000000000000000000010000000010000000001
1000000000000100000000000000000000000000000010000000010000000001
1000000000000100000000000000000000000000000010000000010000000001
1000000000000100000000000000000000000000000010000000010000000001
1000000000000100000000000000000000000000000000000000010000000001
10000000000000000000000001111111100000000000000000000100000-0001
1000000000000000000000000100000000000000000000000000010000000001
1000000000000000000000000100000000000000000000000000010000000001
1000000000000000000000000100000000000200000000000000010000000001
1000000000000000000000000100000000000000000000000000010000000001
10000000000000000000000001000000000000000*0000000000010000000001
1111111111111100000000000100000000000000000011111111110000000001
10000000*0000100000000000100000000000000000010000000010000000001
1000000000000100000000000100000000000000000010000000010000000001
1000000000000100000000000100000000000000000010000000010000000001
1000000000000100000000000100000000000000000010000000010000000001
1000000000000100000000000100000000000000000010000000010000000001
1111111111111111111111111111111111111111111111111111111111111111