1111111111111111111111111111111111111111111111111111111111111111
1000000000000000000000000000010000000000000001000000000000000001
1000000000000000000000000000010000000000000001000000000000000001
1000000000000000000000000000010000000000000001000000000000000001
1111111111111100000000000000010000000000000001000000011111111111
1000000100000000000000000000010000000000000001000000010000000001
1000000100000000000000000000010000000000000001000000010000000001
1000000100000000000000000000010000011111000001000000010000000001
1000000100000000000000000000000000000000000000000000010000000001
1000000100000000000000000000000000000000000000000000010000000001
1000000111111100000000000000000000000000000000000000010000000001
1000000000000100000000000000000000000000000000000000010000000001
1000000000000100000000000000000010000000000000000000010000000001
1000000000000100000000000000000010000000000000000000010000000001
1000000000000100000000000000000010000000000010000000010000000001
1000000111111100000000000000000010000000000010000000010000000001
1000000000000000000000000000000010000000000010000000000000000001
1000000000000000000000000000000010000000000010000000000000000001
1000000000000000000000000000000010000000000010000000000000000001
1000000000000000000000000000000010000000000010000000000000000001
1000000000000000000000000000000010000000000010000000000000000001
1000000000000100000000000000000010000000000010000000000000000001
1000000000000100000000000000000010000000000010000000000000000001
1000000000000100000000000111111110000000000010000000000000000001
1000000000000100000000000000000000000000000010000000010000000001
1000000000000100000000000000000000000000000010000000010000000001
1000000000000100000000000000000000000000000010000000010000000001
1000000000000100000000000000000000000000000010000000010000000001
1000000000000100000000000000000000000000000010000000010000000001
1000000000000100000000000000000000000000000000000000010000000001
10000000000000000000000001111111100000000000000000000100000-0001
1000000000000000000000000100000000000000000000000000010000000001
1000000000000000000000000100000000000000000000000000010000000001
1000000000000000000000000100000000000000000000000000010000000001
1000000000000000000000000100000000000000000000000000010000000001
1000000000000000000000000100000000000000000000000000010000000001
1111111111111100000000000100000000000000000011111111110000000001
1000000000000100000000000100000000000000000010000000010000000001
1000000000000100000000000100000000000000000010000000010000000001
1000000000000100000000000100000000000000000010000000010000000001
1000000000000100000000000100000000000000000010000000010000000001
1000000000000100000000000100000000000000000010000000010000000001
1111111111111111111111111111111111111111111111111111111111111111
