0000000000000000000000000000000000000000000000000000000000000000
0000000000000000000000000000000000000000000000000000000000000000
0000000000000000000000000000000000000000000000000000000000000000
0000000000000000000000000000000000000000000000000000000000000000
0000000000000000000000000000000000000000000000000000000000000000
0000000000000000000000000000000000000000000000000000000000000000
0000000000000000000000000000000000000000000000000000000000000000
0000000000000000000000000000000000000000000000000000000000000000
0000000000000011111111111111111111111111111111111000000000000000
0000000000000010000000000000000000000000000001001000000000000000
0000000000000010000000000000000004000000000001001000000000000000
0000000000000010000000000000000000000000000001111000000000000000
0000000000000010000001111111111111111100000000001000000000000000
0000000000000010000001000000000000000100000000001000000000000000
0000000000000010000001111111000000000100000000001000000000000000
0000000000000010000000000001000000000100000000001000000000000000
00000000000000100000*0000001000000000111110000001000000000000000
0000000000000010000000000001000000000000010000001000000000000000
0000000000000010000000000001000000000000010000001000000000000000
0000000000000010000000000001000000011111110000001000000000000000
0000000000000010000001111111000000010000000000001000000000000000
0000000000000010000001000000000000010000000000001000000000000000
0000000000000010000001000000000000011111110000001000000000000000
0000000000000010000001000000000000000000010000001000000000000000
0000000000000010000001000000011111000000010000001000000000000000
0000000000000010000001000000010001000000010000001000000000000000
0000000000000010000001000000010001000000010000001000000000000000
0000000000000010000001000000010001000000010000001000000000000000
0000000000000010000001111111110001111111110000001000000000000000
0000000000000010000000000000000000000000000000001000000000000000
0000000000000010000000000000000000000000000000001000000000000000
0000000000000010000000000000000000000000000000001000000000000000
0000000000000010000000000000000000000000000000001000000000000000
0000000000000011111111111111111111111111111111111000000000000000
0000000000000000000000000000000000000000000000000000000000000000
0000000000000000000000000000000000000000000000000000000000000000
0000000000000000000000000000000000000000000000000000000000000000
0000000000000000000000000000000000000000000000000000000000000000
0000000000000000000000000000000000000000000000000000000000000000
0000000000000000000000000000000000000000000000000000000000000000
0000000000000000000000000000000000000000000000000000000000000000
0000000000000000000000000000000000000000000000000000000000000000
0000000000000000000000000000000000000000000000000000000000000000
