0000000000000000000000000000000000000000000000000000000000000000
0000000000000000000000000000000000000000000000000000000000000000
0000000000000000000000000000000000000000000000000000000000000000
0000000000000000000000000000000000000000000000000000000000000000
0000000000000000000000000000000000000000000000000000000000000000
0000000000000000000000000000000000000000000000000000000000000000
0000000000000000000000000000000000000000000000000000000000000000
0000000000000000000000000000000000000000000000000000000000000000
0000000000000000000000000000000000000000000000000000000000000000
0000000000000000000000000000000000000000000000000000000000000000
0000000000000000000000000000000000000000000000000000000000000000
0000000000000000000000000000000000000000000000000000000000000000
0000000000001111111111111111111111111111111111111000000000000000
0000000000001000000000000000000000000000000000001000000000000000
0000000000001000000000000000000050000000000000001000000000000000
0000000000001000000000000000000000000000000000001000000000000000
0000000000001000000000111111000000011111100000001000000000000000
0000000000001000000000100001000000010000100000001000000000000000
0000000000001000000000100001000000010000100000001000000000000000
0000000000001000000000100001000000010000100000001000000000000000
0000000000001000000000100001000000010000100000001000000000000000
0000000000001000000000100001000000010000100000001000000000000000
1111111111111000000000000000000000000000000000001111111111100000
1000000000000000000002000000000000000000000000000000000000100000
1000000000000000000000000000000000000040000000000000000000100000
1000000000000000000000000000000000000000000000000000000000100000
1111111111111000000011111110000000100000011111110000000000100000
0000010000000000000010000010000000100000010000010000030000100000
0000010000000000000010000010000000100000010000010000000000100000
0000010000000000000010000010000000100000010000010000000000100000
0000010000000000000010000010000000100000010000010000000000100000
0000011111111111111110000011111111111111110000011111111111100000
0000000000000000000000000000000000000000000000000000000000000000
0000000000000000000000000000000000000000000000000000000000000000
0000000000000000000000000000000000000000000000000000000000000000
0000000000000000000000000000000000000000000000000000000000000000
0000000000000000000000000000000000000000000000000000000000000000
0000000000000000000000000000000000000000000000000000000000000000
0000000000000000000000000000000000000000000000000000000000000000
0000000000000000000000000000000000000000000000000000000000000000
0000000000000000000000000000000000000000000000000000000000000000
0000000000000000000000000000000000000000000000000000000000000000
0000000000000000000000000000000000000000000000000000000000000000
