0000000000000000000000000000000000000000000000000000000000000000
0000000000000000000000000000000000000000000000000000000000000000
0000000000000000000000000000000000000000000000000000000000000000
0000000000000000111111111111111111111111111111111000000000000000
0000000000000000100000000000000000000000000000001000000000000000
0000000000000000100000000000000000000000400000001000000000000000
0000000000000000100000000000000000000000000000001000000000000000
0000000000000000100000000000000000000000000000001000000000000000
0000000000000000100000000000000000000000000000001000000000000000
0000000000000000100000000000000000000000000000001000000000000000
000000000000000010000000001111111111100000*000001000000000000000
0000000000000000100000000000000000001000000000001000000000000000
0000000000000000100000000000000000001000000000001000000000000000
0000000000000000100000000000050000001000000000001000000000000000
0000000000000000100000000000000000001000000000001000000000000000
0000000000000000100000000000000000001000000000001000000000000000
0000000000000000100000000011111111111111111111111000000000000000
0000000000000000100000000010000000000000000000001000000000000000
0000000000000000100000000010000000000000000000001000000000000000
0000000000000000100000000010000000000000000000001000000000000000
0000000000000000100000000010000000002000000000001000000000000000
0000000000000000100000000010000000000000000000001000000000000000
0000000000000000100000000010000000000000000000001000000000000000
0000000000000000100000000010000000000000000000001000000000000000
0000000000000000100000000010000000000000000000001000000000000000
0000000000000000100000000011111111111000000000001000000000000000
0000000000000000100000000000000000000000000000001000000000000000
0000000000000000100000000000000000000000000000001000000000000000
000000000000000010000000000000000000*000000000001000000000000000
0000000000000000100000000000000000000000000000001000000000000000
0000000000000000100000000000000000000000000000001000000000000000
0000000000000000100000000011111111111000000000001000000000000000
0000000000000000100000000010000000001000000000001000000000000000
0000000000000000100000000010000000001000000000001000000000000000
0000000000000000100000000010000000001000000000001000000000000000
00000000000000001000*0000010006000001000000000001000000000000000
000000000000000010000000000000000000100000*000001000000000000000
0000000000000000100000000000000000001000000000001000000000000000
0000000000000000100000000000000000001000000000001000000000000000
0000000000000000111111111111111111111111111111111000000000000000
0000000000000000000000000000000000000000000000000000000000000000
0000000000000000000000000000000000000000000000000000000000000000
0000000000000000000000000000000000000000000000000000000000000000
