0000000000000000000000000000000000000000000000000000000000000000
0000000000000000000000000000000000000000000000000000000000000000
0000000000000000000000000000000000000000000000000000000000000000
0000000000000000111111111111111111111111111111111000000000000000
0000000000000000100000000000000000000000000000001000000000000000
0000000000000000100000000000000000000000000000001000000000000000
0000000000000000100000000000000000000000000000001000000000000000
0000000000000000100000000000000000000000000000001000000000000000
0000000000000000100000000000000000000000000000001000000000000000
0000000000000000100000000000000000000000000000001000000000000000
0000000000000000100000000011111111111000000000001000000000000000
0000000000000000100000000000000000001000000000001000000000000000
0000000000000000100000000000000000001000000000001000000000000000
0000000000000000100000000000000000001000000000001000000000000000
0000000000000000100000000000000000001000000000001000000000000000
0000000000000000100000000000000000001000000000001000000000000000
0000000000000000100000000011111111111111111111111000000000000000
0000000000000000100000000010000000000000000000001000000000000000
0000000000000000100000000010000000000000000000001000000000000000
0000000000000000100000000010000000000000000000001000000000000000
0000000000000000100000000010000000000000000000001000000000000000
0000000000000000100000000010000000000000000000001000000000000000
0000000000000000100000000010000000000000000000001000000000000000
0000000000000000100000000010000000000000000000001000000000000000
0000000000000000100000000010000000000000000000001000000000000000
0000000000000000100000000011111111111000000000001000000000000000
0000000000000000100000000000000000000000000000001000000000000000
0000000000000000100000000000000000000000000000001000000000000000
0000000000000000100000000000000000000000000000001000000000000000
0000000000000000100000000000000000000000000000001000000000000000
0000000000000000100000000000000000000000000000001000000000000000
0000000000000000100000000011111111111000000000001000000000000000
0000000000000000100000000010000000001000000000001000000000000000
0000000000000000100000000010000000001000000000001000000000000000
0000000000000000100000000010000000001000000000001000000000000000
0000000000000000100000000010000000001000000000001000000000000000
0000000000000000100000000000000000001000000000001000000000000000
0000000000000000100000000000000000001000000000001000000000000000
0000000000000000100000000000000000001000000000001000000000000000
0000000000000000111111111111111111111111111111111000000000000000
0000000000000000000000000000000000000000000000000000000000000000
0000000000000000000000000000000000000000000000000000000000000000
0000000000000000000000000000000000000000000000000000000000000000
