0000000000000000000000000000000000000000000000000000000000000000
0000000000000000000000000000000000000000000000000000000000000000
0000000000000000000000000000000000000000000000000000000000000000
0000000000000000000000000000000000000000000000000000000000000000
0000000000111111111111111111111111111111111111111111100000000000
0000000000100000000000001000000000000010000006000000100000000000
0000000000100000000000001000000000000010000000000000100000000000
0000000000100000*00000001000000600000010000000000000100000000000
0000000000100000000000001000000000000010000000000000100000000000
0000000000100000000000000000000000000010000000000000100000000000
0000000000100000000000000000000000000010000000000000100000000000
0000000000100000000000000000000000000010000000000000100000000000
0000000000100000000000000000000000000010000000000000100000000000
0000000000100000000000000000000000000010000000000000100000000000
0000000000100000000000000000000000000010000000000000100000000000
0000000000100000000000001000000000000010000000000000100000000000
000000000010000000000000100000000000001000000*000000100000000000
0000000000100000000000001000000300000010000000000000100000000000
0000000000100000000000001000000000000010000000000000100000000000
0000000000100000000000001000000000000010000000000000100000000000
0000000000100000000000001000000000000010000000000000100000000000
0000000000100000000000001000000000000010000000000000100000000000
0000000000100000000000001000000000000010000000000000100000000000
0000000000100000000000001000000000000010000000000000100000000000
0000000000100000000000001000000000000010000000000000100000000000
0000000000100000000000001000000000000010000000000000100000000000
0000000000100000000000001000000000000010000000000000100000000000
0000000000100000000000001000000000000000000000000000100000000000
0000000000100000000000001000002000*00000000000000000100000000000
0000000000100000000000001000000000000000000000000000100000000000
0000000000100000000000001000000000000000000000000000100000000000
0000000000100000000000001000000000000000000000000000100000000000
0000000000100000000000001000000000000000000000000000100000000000
00000000001000000*0000001000000000000000000000000000100000000000
0000000000100000000000001000000000000010000000000000100000000000
0000000000100000000000001000000000000010000000000000100000000000
0000000000100000000000001000000000000010000000000000100000000000
0000000000100000000000001000000000000010000000000000100000000000
0000000000111111111111111111111111111111111111111111100000000000
0000000000000000000000000000000000000000000000000000000000000000
0000000000000000000000000000000000000000000000000000000000000000
0000000000000000000000000000000000000000000000000000000000000000
0000000000000000000000000000000000000000000000000000000000000000