0000000000000000000000000000000000000000000000000000000000000000
0000000000000000000000000000000000000000000000000000000000000000
0000000000000000000000000000000000000000000000000000000000000000
0000000000000000000000000000000000000000000000000000000000000000
0000000000111111111111111111111111111111111111111111100000000000
0000000000100000000000001000000000000010000000000000100000000000
0000000000100000000000001000000000000010000000000000100000000000
0000000000100000000000001000000000000010000000000000100000000000
0000000000100000000000001000000000000010000000000000100000000000
0000000000100000000000000000000000000010000000000000100000000000
0000000000100000000000000000000000000010000000000000100000000000
0000000000100000000000000000000000000010000000000000100000000000
0000000000100000000000000000000000000010000000000000100000000000
0000000000100000000000000000000000000010000000000000100000000000
0000000000100000000000000000000000000010000000000000100000000000
0000000000100000000000001000000000000010000000000000100000000000
0000000000100000000000001000000000000010000000000000100000000000
0000000000100000000000001000000000000010000000000000100000000000
0000000000100000000000001000000000000010000000000000100000000000
0000000000100000000000001000000000000010000000000000100000000000
0000000000100000000000001000000000000010000000000000100000000000
0000000000100000000000001000000000000010000000000000100000000000
0000000000100000000000001000000000000010000000000000100000000000
0000000000100000000000001000000000000010000000000000100000000000
0000000000100000000000001000000000000010000000000000100000000000
0000000000100000000000001000000000000010000000000000100000000000
0000000000100000000000001000000000000010000000000000100000000000
0000000000100000000000001000000000000000000000000000100000000000
0000000000100000000000001000000000000000000000000000100000000000
0000000000100000000000001000000000000000000000000000100000000000
0000000000100000000000001000000000000000000000000000100000000000
0000000000100000000000001000000000000000000000000000100000000000
0000000000100000000000001000000000000000000000000000100000000000
0000000000100000000000001000000000000000000000000000100000000000
0000000000100000000000001000000000000010000000000000100000000000
0000000000100000000000001000000000000010000000000000100000000000
0000000000100000000000001000000000000010000000000000100000000000
0000000000100000000000001000000000000010000000000000100000000000
0000000000111111111111111111111111111111111111111111100000000000
0000000000000000000000000000000000000000000000000000000000000000
0000000000000000000000000000000000000000000000000000000000000000
0000000000000000000000000000000000000000000000000000000000000000
0000000000000000000000000000000000000000000000000000000000000000