1111111111111111111111111111111111111111111111111111111111111111
1000000000000000000000000000000000000000000000000000000000000001
1000000000000000000000000000000000000000000000000000000000000001
1000000000000000000000000000000000000000000000000000000000000001
1000000000000000000000000000000000000000000000000000000000000001
1000000000000000000001111111111111111111110000000000000000000001
1000000000000000000001000000000000000000010000000000000000000001
1000000000000000000001000000000000000000010000000000000000000001
1000000000000000000001111111111111111111110000000000000000000001
1000001111100000100000000000000000000000000000100000111110000001
1000000000100000100000000000000000000000000000100000100000000001
1000000000100000100000000000000000000000000000100000100000000001
1000000000100000100000000000000000000000000000100000100000000001
1000000000100000100000000000000000000000000000100000100000000001
1000000000100000100000000000000000000000000000100000100000000001
1000000000100000100000000000000000000000000000100000100000000001
1000000000100000100000000000000000000000000000100000100000000001
1000000000100000100000000000000000000000000000100000100000000001
1000000000100000100000000000000000000000000000100000100000000001
10000*0000100000100000000000000000000000000000100000100000000001
1000000000100000100000000000000000000000000000100000100000000001
1000000000100000100000000000000000000000000000100000100000000001
1000000000100000100000000000000000000000000000100000100000000001
1000000000100000100000000000000000000000000000100000100000000001
1000000000100000100000000000000000000000000000100000100000000001
1000000000100000100000000000000000000000000000100000100000000001
1000000000100000100000000000000000000000000000100000100000000001
1000000000100000100000000000000000000000000000100000100000000001
100000000010000010000000000000000000000000000010000010000*000001
1000000000100000100000000000000000000000000000100000100000000001
1000000000100000100000000000000000000000000000100000100000000001
1000000000100000100000000000000000000000000000100000100000000001
1000001111100000100000000000000000000000000000100000111110000001
1000000000000000000001111111111111111111110000000000000000000001
1000000000000000000001000000000000000000010000000000000000000001
1000000000000000000001000000000000000000010000000000000000000001
1000000000000000000001111111111111111111110000000000000000000001
10000000000000000000000000000000*0000000000000000000000000000001
1000000000*00000000000000000000000000000000000000000000000000001
1000000000000000000000000000000000000000000000000000000000000001
1000000000000000000000000000000000000000000000000000000000000001
1000000000000000000000000000000000000000000000000000000000000001
1111111111111111111111111111111111111111111111111111111111111111
